01010101010101010101
01020202010101010101
01010102010101010101
01010102010101010101
01010102020202010101
01010101010102010101
01010101010103010101
01010101010101010101
texture[0202]=C:\Users\doppler\Desktop\textures.png