01010101010101010101
01020201010101010101
01010201010101010101
01010201010101010101
01010202020101010101
01010101020101010101
01010101020301010101
01010101010101010101
texture[0202]=C:\Users\deben_000\IdeaProjects\CorgiAcademy\out\artifacts\textures.png