01010101010101010101
01020201010101010101
01010201010101010101
01010201010101010101
01010202020201010101
01010101010201010101
01010101010301010101
01010101010101010101
texture[0202]=C:\Users\doppler\Desktop\textures.png