01010101010101010101
01020202020301010101
01020101010101010101
01020102020201010101
01020102010201010101
01020101010201010101
01020202020201010101
01010101010101010101
texture[0202]=C:\Users\doppler\Desktop\textures.png