01010101010101010101
01010101010101010101
01010102020201010101
01010102010201010101
01010102010201010101
01020202010202030101
01010101010101010101
01010101010101010101
texture[0202]=C:\Users\doppler\Desktop\textures.png