01010101010101010101
01020202020201010101
01020302020201010101
01020202020201010101
01020202020201010101
01020202020201010101
01020202020201010101
01010101010101010101
texture[0202]=C:\Users\doppler\Desktop\textures.png